#############
#SSH--------#
#-----------#
#-----------#
#----A------#
#-----------#
#-----------#
#############