#################
#SSH------------#
#---------------#
#---------------#
#---------------#
#-------A-------#
#---------------#
#---------------#
#---------------#
#SSH------------#
#################