#############
#SSH---#----#
#------#----#
#------#----#
#----A-#----#
#------#----#
#------#----#
#------#----#
#-----------#
#-----------#
#############